NO ./path_to_the_north_texture
SO ./path_to_the_south_texture
WE ./path_to_the_west_texture
EA ./path_to_the_east_texture

F 220,100,0
C 225,30,0

        1111111111111111111111111
        1000000000000000000000001
        1000000000000000000000001
        1001000000000000000000001
1111111110110000011100000000000A1
100000000000000000000000000000111
111101111111110111000000100011
11110111111111011101010010001
11000000110101011100000010001
10000000000000001100000010001
10000000000000001101010010001
110000000000000000000000N0111
1111011111110101111011110100011
1111111111111111111111111111111