
NO ./src/textures//north_texture.png
SO ./src/textures//south_texture.png
EA ./src/textures//east_texture.png
WE ./src/textures//west_texture.png

C 155,100,160
F 111,111,111

111111
1 0111
111111
111111
1N1111
111111
