
NO ./src/textures//north_texture.png
SO ./src/textures//south_texture.png
EA ./src/textures//east_texture.png
WE ./src/textures//west_texture.png

C 155,100,160
F 111,111,111

11111111111111111
10000000000000001
10100000100000101
10000000000000001
10001000100010001
10000000W00000001
10101010101010101
1000000000000000111
10001000100100001011
10000000000000001111 0
10100000100001000
10000000000000001
11111111111111111
