
NO ./textures_xpm/north_texture.png
SO ./textures_xpm/south_texture.png
EA ./textures_xpm/east_texture.png
WE ./textures_xpm/west_texture.png

C 155,100,160
F 111,111,111

11111111111111111
10000000000000001
10100000100000101
10000000000000001
10001000100010001
10000000W00000001
10101010101010101
100000000000000011
10001000100100001011
100000000000000011
10100000100001000
10000000000000001
11111111111111111
