111111111111
100100001111
100000000001
1000P0001111
100100001111
100000000001
100000001111
111111111111