1111111111111111111111111111111111111111111111
1111001001011111100000000111111111111111111111
1111000000001111100000000111111111111111111111
1111000000011100000000000111111111111111111111
1111001000000101100000000111110000000000000001
1111000000000P11100000000000000000000000000001
1111000000011111100000000000000000000000000001
1111000000011111100000000000000000000000000001
1111000000011111100000000111111111111111111111
1111000000011111100000000111111111111111111111
1111000000011111100000000111111111111111111111
1111111111111111111111111111111111111111111111
