111111111111
100100101111
100000000111
1000P0001111
100100001111
100000000001
100000001111
111111111111