11111111111111111111111
10010010111111000000001
10000000011111000000001
10000000111000000000001
10010000001011000000001
1000000000P111000000001
10000000111111000000001
11111111111111111111111